###################################
#						  #       #
#     ################ ####       #
#     #              # #    ### # #
#     #############  # #      # # #
#                 #  # ######## ###
#####  ### ########  #            #
#  ##    # #         ##############
#  ##    # #                    # #
#   #    # #                    # #
#   ###### ####### ############## #
#                                 #
###################################